0000000000000000
0000000000000000
0000000000000000
0000011100000000
0000013100000000
0000012111100000
0001114243100000
0001324611100000
0001111410000000
0000001310000000
0000001110000000
0000000000000000
0000000000000000
0000000000000000