0000000000000000
0000000000000000
0000000000000000
0000000000000000
0000001111110000
0000001222210000
0000111444210000
0000162433210000
0000124333110000
0000111122100000
0000000111100000
0000000000000000
0000000000000000
0000000000000000