0000000000000000
0000000000000000
0000000000000000
0000000000000000
0001111001111100
0011221001222100
0012421111422100
0012243333242100
0011222212621100
0001111111111000
0000000000000000
0000000000000000
0000000000000000
0000000000000000