0000000000000000
0000000000000000
0000001111100000
0000111226100000
0000122432110000
0000122343210000
0000111254210000
0000001222110000
0000001111100000
0000000000000000
0000000000000000
0000000000000000
0000000000000000
0000000000000000