0000000000000000
0000000000000000
0000000000000000
0000011110000000
0000013310000000
0000112311000000
0000122431000000
0001124221100000
0001221442100000
0001226222100000
0001111111100000
0000000000000000
0000000000000000
0000000000000000