0000000000000000
0000000000000000
0000000000000000
0001111111100000
0001221222100000
0001243342100000
0001643521100000
0001243342100000
0001221222100000
0001111111100000
0000000000000000
0000000000000000
0000000000000000
0000000000000000