0000000000000000
0000000000000000
0000000000000000
0000111111110000
0000112222110000
0000124244210000
0000133333310000
0000124424210000
0000111261110000
0000001111000000
0000000000000000
0000000000000000
0000000000000000
0000000000000000