0000000000000000
0000000000000000
0000000000000000
0000001111110000
0000001222211100
0000001242222100
0000111242112100
0000133324222100
0000133341421100
0000111121242100
0000000122622100
0000000111111100
0000000000000000
0000000000000000