0000000000000000
0000000000000000
0000000000000000
0000111111000000
0000122221000000
0000124441100000
0000122133111000
0000112233421000
0000012622221000
0000011111111000
0000000000000000
0000000000000000
0000000000000000
0000000000000000