0000000000000000
0000000000000000
0000011111111000
0000012221321000
0000112243331000
0000122421531000
0001121141211000
0001222422421000
0001222122221000
0001111111621000
0000000001111000
0000000000000000
0000000000000000
0000000000000000