0000000000000000
0000000000000000
0000111111100000
0000133332100000
0001113334111000
0001224142421000
0001244221421000
0001222212221000
0001111262111000
0000001111100000
0000000000000000
0000000000000000
0000000000000000
0000000000000000