########
#     .#
# $@$  #
#     .#
########