0000000000000000
0000000000000000
0001111100000000
0001622100000000
0001244101110000
0001242101310000
0001112111310000
0000112222310000
0000122212210000
0000122211110000
0000111110000000
0000000000000000
0000000000000000
0000000000000000