###########
#     ..  #
# $@$   $ #
#     ..$ #
#         #
###########