0000000000000000
0000000000000000
0000111111100000
0000133433100000
0000133133100000
0000124442100000
0000122422100000
0000124442100000
0000122162100000
0000111111100000
0000000000000000
0000000000000000
0000000000000000
0000000000000000