0000000000000000
0000011111100000
0000012333100000
0011113333100000
0012211142111000
0012424224421000
0012242422221000
0016221112221000
0011111001111000
0000000000000000
0000000000000000
0000000000000000
0000000000000000
0000000000000000