0000000000000000
0000000000000000
0011111111000000
0012222221000000
0012144221000000
0012333121000000
0011333421100000
0001211242100000
0001422422100000
0001221622100000
0001111111100000
0000000000000000
0000000000000000
0000000000000000