0000000000000000
0000000000000000
0000000000000000
0000001111100000
0000111222111100
0000122242422100
0000124222426100
0000111441111100
0000001223310000
0000001333310000
0000001111110000
0000000000000000
0000000000000000
0000000000000000