0000000000000000
0000000000000000
1111110001111100
1222211101223100
1224242101333100
1212242111223100
1224442224263100
1112242241223100
0012241421333100
0011222221223100
0001111111111100
0000000000000000
0000000000000000
0000000000000000