0000000000000000
0000000111111000
0001111132221000
0001221331121000
0001224332221000
0001221231211000
0011121141221000
0012422224421000
0012141221221000
0016221111111000
0011111000000000
0000000000000000
0000000000000000
0000000000000000