0000000000000000
0011111111111100
0012221122111100
0012422222222100
0011411121122100
0012211252121100
0012433333321000
0112111232121000
0122222411141000
0122212222461000
0111114121111000
0000012221000000
0000011111000000
0000000000000000