0000001111111110
0000001222222210
0000001212121210
0000001224241210
1111111222422210
1331221124241210
1332221124242210
1331221121111110
1331212424210000
1332222242210000
1221112621110000
1111011111100000
0000000000000000
0000000000000000