0000111100000000
1111122100000000
1224242101111111
1222422101535351
1124242111353531
1142422122535351
1164242222353511
1142422122535351
1124242111353531
1222422101535351
1224242101111111
1111122100000000
0000111100000000
0000000000000000