0000000000000000
0000000000000000
0000000000000000
0000000000000000
0000111111110000
0000133333310000
0000122421211000
0000124212421000
0000114242421000
0000012262221000
0000011111111000
0000000000000000
0000000000000000
0000000000000000