0000000000000000
0000000000000000
0000000000000000
0000111111100000
0000122222111000
0001141112221000
0001262422421000
0001233124211000
0001133122210000
0000111111110000
0000000000000000
0000000000000000
0000000000000000
0000000000000000