0000000000000000
0000000000000000
0000000000000000
0000011111111110
0001112223222210
0001222114112210
0001264323234110
0001124114112100
0000122223222100
0000111111111100
0000000000000000
0000000000000000
0000000000000000
0000000000000000