0000000000000000
0000000000000000
0000000111111000
0000111132261000
0000122444221000
0000131131131000
0000122242221000
0000122431211000
0000111122210000
0000000111110000
0000000000000000
0000000000000000
0000000000000000
0000000000000000