0000000000000000
0000000000000000
0000000000000000
0000011111100000
0000013233100000
0000013243100000
0000111224110000
0000124224210000
0000121411210000
0000122262210000
0000111111110000
0000000000000000
0000000000000000
0000000000000000