0000000000000000
0000111111000000
0011122221110000
0012221422211100
0012224222442100
0012442142222100
0011222422242100
1111112141111100
1336214221000000
1313322411000000
1333341210000000
1333322210000000
1111111110000000
0000000000000000