1111111111111110
1222222122222210
1242142124114210
1212242122222210
1222114141144210
1212123332122210
1242232123421210
1241643331212210
1222232123224210
1211341114321210
1212433333211210
1222222222222210
1111111111111110
0000000000000000