0000000000000000
0000000000000000
0001111111110000
0001222112210000
0001212424210000
0001225312210000
0001121363110000
0001141115111000
0001222222221000
0001222112121000
0001111112221000
0000000011111000
0000000000000000
0000000000000000