1111111100000000
1222222100000000
1244222111000000
1224244421111100
1121123332222110
0121613331114210
0121243332222210
1121243334212110
1221111121112100
1222222422242100
1111111111122100
0000000000111100
0000000000000000
0000000000000000