0111100000011110
0133100000013310
0133111111113310
0124233333343410
0142424242424210
0124242464242410
0142424242424210
0124242424242410
0143433333324210
0133111111113310
0133100000013310
0111100000011110
0000000000000000
0000000000000000