1111111100000000
1222122100000000
1333442111111100
1333122222222100
1333141111112100
1333122222212110
1111124241212210
0000124242421210
0000122124226210
0000124424111110
0000122222100000
0000111111100000
0000000000000000
0000000000000000