0000000000000000
0011111111100000
0012221222111000
0012424234221000
0012131313121000
0012434643421000
0012131313121000
0012243242421000
0011111112221000
0000000011111000
0000000000000000
0000000000000000
0000000000000000
0000000000000000