0000000000000000
0000000000000000
0000000000000000
0000111100000000
0001122100000000
0001642100000000
0001142110000000
0001124210000000
0001342210000000
0001335310000000
0001111110000000
0000000000000000
0000000000000000
0000000000000000