0000000000000000
0011111111100000
0012222222100000
0014442444100000
0013333333100000
0013331333100000
0014444444100000
0012226222100000
0011111111100000
0000000000000000
0000000000000000
0000000000000000
0000000000000000
0000000000000000