0000000000000000
0000000000000000
0000111110000000
0000162111000000
0000124221000000
0001112121100000
0001312122100000
0001342212100000
0001322242100000
0001111111100000
0000000000000000
0000000000000000
0000000000000000
0000000000000000