0000000000000000
0000111111100000
0111122222100000
0122231112100000
0121212222110000
0121242413210000
0121225221210000
0123142421210000
0112222121211100
0012111322226100
0012222211222100
0011111111111100
0000000000000000
0000000000000000