0000000000000000
0000000000000000
0000000000000000
0000001111111100
0000001122126100
0000001222122100
0000001424242100
0000001241122100
0000111242121100
0000133333221100
0000111111111100
0000000000000000
0000000000000000
0000000000000000