0000000000000000
0000000000000000
0000000000000000
0000001111110000
0000111222210000
0001132411211000
0001334242261000
0001332424211000
0001111112210000
0000000011110000
0000000000000000
0000000000000000
0000000000000000
0000000000000000