0000000000000000
0000000000000000
0000000000000000
0001111111110000
0001221122210000
0001222422210000
0001421112410000
0001213331210000
0011213331211000
0012422422421000
0012222212621000
0011111111111000
0000000000000000
0000000000000000